





























































