





























































